=== Puzzle 1 === (Solution: 5 steps)
Player: (18, 2), Boxes: [(17, 2)], Targets: [(15, 3)]
####################
####__##############
###___##############
#______#############
#______#############
#______#############
#_______############
#_____##############
#__#################
#_##################
#__#################
#_##################
#_##################
#__#################
#_____##############
#__O################
#___################
#_X__###############
#_P__###############
####################
Solution: Up || Up || Left || Up || Right

=== Puzzle 2 === (Solution: 5 steps)
Player: (17, 11), Boxes: [(17, 10)], Targets: [(16, 8)]
####################
####################
####################
#######__###########
######__############
######__############
######__############
######__############
######__############
#######_#_##########
######__________####
#######___#_____####
############___#####
############___#####
#######_####___#####
######__#_###___####
#####___O___#___####
#####_____XP#___####
####____________####
####################
Solution: Left || Left || Down || Left || Up

=== Puzzle 3 === (Solution: 5 steps)
Player: (14, 7), Boxes: [(15, 7)], Targets: [(16, 9)]
####################
#############____###
##############___###
##############__##_#
##############__##_#
##############__#__#
#############__##__#
#############__##__#
##############__#__#
##############__#__#
##############__#__#
#############______#
##############_____#
################___#
##___##P######_##__#
##__#__X___________#
##__##___O_#_#_____#
##__###__########_##
##______############
####################
Solution: Down || Left || Down || Right || Right

=== Puzzle 4 === (Solution: 5 steps)
Player: (2, 1), Boxes: [(2, 2)], Targets: [(3, 4)]
####################
##_____#############
#PX____#############
##__O__#############
#__#################
#__#################
#___################
#____###############
#______#############
#______#############
#____###############
#______#############
##____##############
####__##############
####__#####________#
####___###_______#_#
#####________####__#
#####________####__#
#########_____####_#
####################
Solution: Right || Right || Up || Right || Down

=== Puzzle 5 === (Solution: 5 steps)
Player: (8, 11), Boxes: [(8, 12)], Targets: [(9, 14)]
####################
####################
####################
####################
####################
####################
####################
###########_______##
###########PX___####
############_#O__###
###############_####
##############__####
###########__#__####
###########__#_____#
##########_________#
############_______#
##########________##
#######____________#
#######____________#
####################
Solution: Right || Right || Up || Right || Down

