=== Puzzle 1 === (Solution: 2 steps)
Player: (8, 1), Boxes: [(7, 1)], Targets: [(5, 1)]
##########
####____##
####_____#
####____##
#####_#_##
#O##__#_##
#__#_____#
#X#______#
#P_______#
##########
Solution: Up || Up

=== Puzzle 2 === (Solution: 2 steps)
Player: (2, 5), Boxes: [(2, 4)], Targets: [(2, 2)]
##########
#______###
#_O_XP####
#__##_####
#_########
#_########
#_########
#_#_#____#
#________#
##########
Solution: Left || Left

=== Puzzle 3 === (Solution: 2 steps)
Player: (8, 2), Boxes: [(7, 2)], Targets: [(5, 2)]
##########
#__#_#___#
#_##_____#
#____#___#
#____#___#
#_O__##__#
#__###___#
#_X###___#
#_P______#
##########
Solution: Up || Up

=== Puzzle 4 === (Solution: 2 steps)
Player: (8, 1), Boxes: [(7, 1)], Targets: [(5, 1)]
##########
#_______##
#______###
#_______##
###____###
#O##___###
#__#___###
#X_#___###
#P_____###
##########
Solution: Up || Up

=== Puzzle 5 === (Solution: 2 steps)
Player: (4, 3), Boxes: [(5, 3)], Targets: [(7, 3)]
##########
###______#
###______#
####_____#
###P_#___#
##_X_#___#
##___#___#
##_O_#___#
#######__#
##########
Solution: Down || Down

