=== Puzzle 1 === (Solution: 1 steps)
Player: (7, 4), Boxes: [(7, 3)], Targets: [(7, 2)]
##########
#____#####
#____#####
#____#####
#____#####
#____#####
#_########
#_OXP##__#
#________#
##########
Solution: Left

=== Puzzle 2 === (Solution: 1 steps)
Player: (7, 1), Boxes: [(7, 2)], Targets: [(7, 3)]
##########
#_##_#___#
#____#___#
#____##__#
#________#
#________#
#_####___#
#PXO#____#
#___##___#
##########
Solution: Right

=== Puzzle 3 === (Solution: 1 steps)
Player: (5, 8), Boxes: [(6, 8)], Targets: [(7, 8)]
##########
#________#
##_______#
##______##
##_###__##
######__P#
#######_X#
#_____#_O#
#________#
##########
Solution: Down

=== Puzzle 4 === (Solution: 1 steps)
Player: (4, 7), Boxes: [(5, 7)], Targets: [(6, 7)]
##########
#__#_#_###
#______###
#______###
#___##_P##
#___##_X_#
#____##O##
#____##__#
#________#
##########
Solution: Down

=== Puzzle 5 === (Solution: 1 steps)
Player: (8, 1), Boxes: [(8, 2)], Targets: [(8, 3)]
##########
#______###
#______###
#______###
#_____####
#___######
#___######
#_####_#_#
#PXO_____#
##########
Solution: Right

