=== Puzzle 1 === (Solution: 4 steps)
Player: (18, 10), Boxes: [(17, 10)], Targets: [(13, 10)]
####################
####################
####################
####################
####################
####################
####################
####################
#####__#############
#_##__##############
#_##__##############
#__#___#############
#__#__##############
#__#___##_O_########
#__##__##__#########
#__#__###__#########
#__#___##__#########
#_____#_#_X#########
#_________P_########
####################
Solution: Up || Up || Up || Up

=== Puzzle 2 === (Solution: 4 steps)
Player: (14, 18), Boxes: [(14, 17)], Targets: [(14, 13)]
####################
#______________#####
#_____________######
#####_######__######
############__######
############__######
############__######
###########___######
###########___######
###########___######
###########__#######
###########___######
############__######
############__#_####
############_O___XP#
############__#__#_#
##################_#
################___#
###########________#
####################
Solution: Left || Left || Left || Left

=== Puzzle 3 === (Solution: 4 steps)
Player: (10, 2), Boxes: [(11, 2)], Targets: [(15, 2)]
####################
#__#################
#__#################
#_##################
#__#################
#_##################
#_##################
#_##################
#_##################
#_##################
#_P#################
#_X#################
#__#################
#__#################
#__#################
#_O#################
#_____##############
#____###############
#______#############
####################
Solution: Down || Down || Down || Down

=== Puzzle 4 === (Solution: 4 steps)
Player: (11, 18), Boxes: [(12, 18)], Targets: [(16, 18)]
####################
#############______#
#########_###______#
######_____________#
#######____________#
##__________##_____#
###________###__#__#
##############__#__#
##############_____#
##############_____#
################__##
################__P#
#################_X#
#################__#
#################__#
#################__#
#################_O#
##################_#
##################_#
####################
Solution: Down || Down || Down || Down

=== Puzzle 5 === (Solution: 4 steps)
Player: (18, 6), Boxes: [(18, 5)], Targets: [(18, 1)]
####################
#####__________#####
#####____#_____#####
#####__###____######
######___#_____#####
#######_____########
#######____#########
######______########
######____##########
#######__###########
#######__###########
#######__###########
#######___##########
#######___##########
#_##_###__#####____#
#__________________#
#__________________#
#_##################
#O___XP#############
####################
Solution: Left || Left || Left || Left

