=== Puzzle 1 === (Solution: 6 steps)
Player: (17, 14), Boxes: [(17, 15)], Targets: [(15, 17)]
####################
####################
#################_##
#############______#
##############_____#
#################__#
#################__#
################___#
################___#
#################__#
#################__#
#################__#
##################_#
#################__#
################___#
################_O##
################___#
##############PX___#
##############_____#
####################
Solution: Right || Right || Down || Right || Up || Up

=== Puzzle 2 === (Solution: 6 steps)
Player: (11, 8), Boxes: [(12, 8)], Targets: [(15, 9)]
####################
#__#################
#__#################
#__#################
#_##################
#__#################
#_____##############
#____###############
#_#___##############
#_#___##############
#_#___##############
#_______P###########
#__#__#_X###########
#_#####___##########
#_#_###__###########
#___###__O_#########
#____##__#_#########
#____##_____########
#____##______#######
####################
Solution: Down || Down || Down || Left || Down || Right

=== Puzzle 3 === (Solution: 6 steps)
Player: (5, 5), Boxes: [(6, 5)], Targets: [(9, 4)]
####################
#_________________##
#________________###
#______######____###
######__#####__#####
###__P__############
####_X_#############
###____#############
###____#############
####O__#############
###_____############
###____#############
###____#############
####################
####################
####################
####################
####################
####################
####################
Solution: Down || Down || Down || Right || Down || Left

=== Puzzle 4 === (Solution: 6 steps)
Player: (12, 4), Boxes: [(13, 4)], Targets: [(14, 1)]
####################
####################
#__#################
#__#################
#____###############
#___################
#___#_##___#########
#_____________######
#___________########
########__##########
#######___##########
#######__###########
####P#___##_###__#_#
#___X______________#
#O_____#___________#
#____###############
#____###############
####################
####################
####################
Solution: Down || Right || Down || Left || Left || Left

=== Puzzle 5 === (Solution: 6 steps)
Player: (18, 17), Boxes: [(17, 17)], Targets: [(14, 16)]
####################
####################
####################
####################
####################
####################
####################
####################
####################
####################
####################
####################
#################__#
#################__#
###############_O__#
###############____#
##############_____#
##############___X_#
##############___P_#
####################
Solution: Up || Up || Up || Right || Up || Left

