=== Puzzle 1 === (Solution: 5 steps)
Player: (np.int64(18), np.int64(8)), Boxes: [(np.int64(17), np.int64(8))], Targets: [(np.int64(12), np.int64(8))]
####################
####################
####################
####################
####################
####################
#######__###########
#######___##########
########__##########
########_####_######
#######__##_______##
#######__##_______##
#######_O_####___###
########__###___####
########__###____###
#######___###___####
#######___###______#
#######_X_###______#
#######_P__________#
####################
Solution: Up || Up || Up || Up || Up

=== Puzzle 2 === (Solution: 5 steps)
Player: (np.int64(12), np.int64(5)), Boxes: [(np.int64(12), np.int64(6))], Targets: [(np.int64(12), np.int64(11))]
####################
#_________##########
#___________########
#___#______#########
#__####____#########
####_###____########
####________########
####_______#########
#_____##############
#____###############
#__#################
#____________#######
#___#PX____O########
##########___#######
#########____#######
###########_########
####################
####################
####################
####################
Solution: Right || Right || Right || Right || Right

=== Puzzle 3 === (Solution: 5 steps)
Player: (np.int64(2), np.int64(10)), Boxes: [(np.int64(2), np.int64(11))], Targets: [(np.int64(2), np.int64(16))]
####################
###########________#
########_#PX____O_##
######___##_####__##
######___##__#######
######____#_########
#___________########
#___#____#__########
#__####_##__########
#__####_##___#######
#__####_##___#######
#__###____#__#######
#__#####_______#####
#__________#__######
#____##_____########
#___###_____########
#__####_____########
#__#_####___########
#__________#########
####################
Solution: Right || Right || Right || Right || Right

=== Puzzle 4 === (Solution: 5 steps)
Player: (np.int64(18), np.int64(2)), Boxes: [(np.int64(17), np.int64(2))], Targets: [(np.int64(12), np.int64(2))]
####################
####################
####################
####################
#__#################
#__#################
#_##################
#_##################
#_##################
#__#################
#__#################
#__#################
#_O_################
#___################
#___################
#___################
#____###############
#_X_################
#_P_################
####################
Solution: Up || Up || Up || Up || Up

=== Puzzle 5 === (Solution: 5 steps)
Player: (np.int64(1), np.int64(1)), Boxes: [(np.int64(2), np.int64(1))], Targets: [(np.int64(7), np.int64(1))]
####################
#P_#################
#X_#################
#_##################
#____###############
#___################
#___################
#O__################
###_################
##___###############
##__################
##___###############
##__################
##___###########__##
###__####_###_##___#
##____________#____#
##_________________#
############_______#
############_______#
####################
Solution: Down || Down || Down || Down || Down

