=== Puzzle 1 === (Solution: 4 steps)
Player: (4, 15), Boxes: [(3, 15)], Targets: [(2, 14)]
####################
##############___###
#############_O__###
#############__X_###
############__#P_###
#############__#__##
#############_#___##
#############_#__###
#############_#__###
###########______###
###########_______##
###########________#
###########________#
############_______#
###########______###
############___#####
############__######
###########___#_####
###########______###
####################
Solution: Up || Right || Up || Left

=== Puzzle 2 === (Solution: 4 steps)
Player: (11, 5), Boxes: [(11, 4)], Targets: [(10, 3)]
####################
####################
####################
####################
####################
####################
####################
####################
####################
####################
###O################
###_XP##############
###___##############
#####_##############
#______#############
#_______############
#__#___#############
#______#############
#_______############
####################
Solution: Left || Down || Left || Up

=== Puzzle 3 === (Solution: 4 steps)
Player: (2, 11), Boxes: [(2, 10)], Targets: [(3, 9)]
####################
###___###__________#
#_____###_XP#_#____#
#______##O_####__###
#___________###__###
#_#_____#_######__##
#_____##########_###
#_##_###############
#__#_###############
#_##################
#__#################
#_##################
#__#################
#_##################
#_##################
#__#################
#_##################
#__#################
#___################
####################
Solution: Left || Up || Left || Down

=== Puzzle 4 === (Solution: 4 steps)
Player: (17, 15), Boxes: [(17, 16)], Targets: [(18, 17)]
####################
####################
####################
####################
####################
####################
######__############
######____##########
#######___##########
#_#_____#_##########
#__________#########
#_____________######
#####___#____#######
#####____##__#######
###_#___###_______##
#________###__##_###
#_______########__##
##______#######PX__#
#_______#########O_#
####################
Solution: Right || Up || Right || Down

=== Puzzle 5 === (Solution: 4 steps)
Player: (16, 3), Boxes: [(16, 2)], Targets: [(17, 1)]
####################
####################
####################
####################
####################
####################
####################
####################
####################
####################
####################
####################
####################
####################
###_################
#___##############_#
#_XP#########______#
#O#__##_#_##_______#
#__________________#
####################
Solution: Left || Up || Left || Down

